{
  "\"": "Ⲯ",
  "'": "ⲯ",
  ",": "ⲭ",
  ":": "Ⲑ",
  ";": "ⲑ",
  "<": "Ⲭ",
  "A": "Ⲁ",
  "B": "Ⲃ",
  "C": "Ⲥ",
  "D": "Ⲇ",
  "E": "Ⲉ",
  "G": "Ⲅ",
  "H": "Ϩ",
  "I": "Ⲓ",
  "J": "Ϫ",
  "K": "Ⲕ",
  "L": "Ⲗ",
  "M": "Ⲙ",
  "N": "Ⲛ",
  "O": "Ⲟ",
  "P": "Ⲡ",
  "Q": "Ϧ",
  "R": "Ⲣ",
  "S": "Ϣ",
  "U": "Ⲩ",
  "V": "Ⲫ",
  "W": "Ⲱ",
  "X": "Ⲝ",
  "Y": "Ⲏ",
  "Z": "Ⲍ",
  "[": "ϭ",
  "]": "ϯ",
  "^": "ⲋ",
  "a": "ⲁ",
  "b": "ⲃ",
  "c": "ⲥ",
  "d": "ⲇ",
  "e": "ⲉ",
  "f": "Ϥ",
  "F": "ϥ",
  "g": "ⲅ",
  "h": "ϩ",
  "i": "ⲓ",
  "j": "ϫ",
  "k": "ⲕ",
  "l": "ⲗ",
  "m": "ⲙ",
  "n": "ⲛ",
  "o": "ⲟ",
  "p": "ⲡ",
  "T": "Ⲧ",
  "q": "ϧ",
  "r": "ⲣ",
  "s": "ϣ",
  "t": "ⲧ",
  "u": "ⲩ",
  "}": "Ϯ",
  "{": "Ϭ",
  "z": "ⲍ",
  "y": "ⲏ",
  "x": "ⲝ",
  "w": "ⲱ",
  "v": "ⲫ",
  "@": ":"
}
